{
  "000002.png": {
    "1": 2,
    "2": 0,
    "3": 0,
    "4": 1,
    "5": 2,
    "6": 0,
    "7": 0,
    "8": 3,
    "9": 3,
    "10": 3,
    "11": 2,
    "12": 1,
    "13": 3,
    "14": 2,
    "15": 1,
    "16": 0,
    "17": 3,
    "18": 1,
    "19": 3,
    "20": 3,
    "21": 3,
    "22": 3,
    "23": 3,
    "24": 2,
    "25": 3,
    "255": 1
  },
  "000003.png": {
    "1": 3,
    "2": 0,
    "3": 0,
    "4": 0,
    "5": 2,
    "6": 2,
    "7": 1,
    "8": 1,
    "9": 3,
    "10": 1,
    "11": 2,
    "12": 1,
    "13": 1,
    "14": 3,
    "15": 3,
    "16": 2,
    "17": 2,
    "18": 2,
    "19": 2,
    "20": 0,
    "21": 3,
    "22": 3,
    "23": 3,
    "24": 0,
    "25": 3,
    "255": 1
  }
}